00000300000000
00303003000000
00030030000000
00300030033000
00003030300300
03300033000000
00330000030000
00003300003033
03303033300300
00333000330300
00000030300000
00003033000000
00030000033000
00000003000000
