33333333333333
33333333332333
33333323000333
33333303000333
33300000003333
33303303303333
33303393303333
33300010010333
33300000000333
33300111000333
33300102000333
33302022000333
33333333333333
33333333333333
