00000000000000
00000000000300
00000002000330
00010000000330
00000201000330
00000000000330
00002000000330
00000010000330
00090000000330
00000000000330
00000000000330
00000000000000
00000000000000
00000000000000
