33333333330000
30000000030000
00100000000300
00009001032300
00000000030300
00333333333330
00000000030000
30010320030000
33300330330000
00030000030000
00030000030200
00000000000000
00000000000033
00000000000000
