00000000000000
00000000000000
03303300303000
00000000000000
00000030000000
00000000000000
00001000000000
00000002000000
00009000000000
00000000000000
00000000000000
00000000000000
00000000000000
00000000000000
