33393333333333
33303000200000
33303033333300
33303033333300
33303033333300
33303033333300
33303033300000
00013033300300
00303033330300
00303000000300
00000100032333
33333303030333
33333300000333
33333333333333